AGE_GROUP,CONFIRMED_by_age,CongregateSetting,FORMRECEIVED_WEEK_ENDING,non_CongregateSetting,REPORTED,ObjectId
20,54,2,2020/04/04 04:00:00+00,52,2022/10/09 10:17:00+00,1
0,3,0,2020/04/11 04:00:00+00,3,2022/10/09 10:17:00+00,2
0,4,0,2020/04/25 04:00:00+00,4,2022/10/09 10:17:00+00,3
20,74,5,2020/04/25 04:00:00+00,69,2022/10/09 10:17:00+00,4
65,58,38,2020/05/02 04:00:00+00,20,2022/10/09 10:17:00+00,5
65,39,16,2020/05/09 04:00:00+00,23,2022/10/09 10:17:00+00,6
0,24,3,2020/05/16 04:00:00+00,21,2022/10/09 10:17:00+00,7
20,165,4,2020/06/06 04:00:00+00,161,2022/10/09 10:17:00+00,8
0,35,0,2020/06/13 04:00:00+00,35,2022/10/09 10:17:00+00,9
20,159,9,2020/06/13 04:00:00+00,150,2022/10/09 10:17:00+00,10
65,69,38,2020/06/13 04:00:00+00,31,2022/10/09 10:17:00+00,11
20,137,9,2020/06/20 04:00:00+00,128,2022/10/09 10:17:00+00,12
45,74,2,2020/06/27 04:00:00+00,72,2022/10/09 10:17:00+00,13
65,28,9,2020/06/27 04:00:00+00,19,2022/10/09 10:17:00+00,14
65,54,22,2020/07/04 04:00:00+00,32,2022/10/09 10:17:00+00,15
20,527,5,2020/08/01 04:00:00+00,522,2022/10/09 10:17:00+00,16
20,534,48,2020/08/08 04:00:00+00,486,2022/10/09 10:17:00+00,17
65,126,19,2020/08/08 04:00:00+00,107,2022/10/09 10:17:00+00,18
0,230,13,2020/08/29 04:00:00+00,217,2022/10/09 10:17:00+00,19
45,199,4,2020/09/12 04:00:00+00,195,2022/10/09 10:17:00+00,20
65,118,27,2020/09/12 04:00:00+00,91,2022/10/09 10:17:00+00,21
45,257,10,2020/09/19 04:00:00+00,247,2022/10/09 10:17:00+00,22
0,187,4,2020/10/10 04:00:00+00,183,2022/10/09 10:17:00+00,23
45,393,10,2020/10/17 04:00:00+00,383,2022/10/09 10:17:00+00,24
65,318,77,2020/10/17 04:00:00+00,241,2022/10/09 10:17:00+00,25
0,278,3,2020/10/31 04:00:00+00,275,2022/10/09 10:17:00+00,26
0,539,4,2020/11/21 05:00:00+00,535,2022/10/09 10:17:00+00,27
20,1628,8,2020/12/05 05:00:00+00,1620,2022/10/09 10:17:00+00,28
45,951,5,2020/12/12 05:00:00+00,946,2022/10/09 10:17:00+00,29
65,548,57,2020/12/12 05:00:00+00,491,2022/10/09 10:17:00+00,30
20,1082,5,2020/12/19 05:00:00+00,1077,2022/10/09 10:17:00+00,31
45,765,10,2020/12/19 05:00:00+00,755,2022/10/09 10:17:00+00,32
0,309,0,2020/12/26 05:00:00+00,309,2022/10/09 10:17:00+00,33
65,411,67,2020/12/26 05:00:00+00,344,2022/10/09 10:17:00+00,34
65,485,63,2021/01/02 05:00:00+00,422,2022/10/09 10:17:00+00,35
20,1780,23,2021/01/09 05:00:00+00,1757,2022/10/09 10:17:00+00,36
0,515,3,2021/01/23 05:00:00+00,512,2022/10/09 10:17:00+00,37
45,814,7,2021/01/30 05:00:00+00,807,2022/10/09 10:17:00+00,38
45,580,11,2021/02/06 05:00:00+00,569,2022/10/09 10:17:00+00,39
65,297,43,2021/02/06 05:00:00+00,254,2022/10/09 10:17:00+00,40
0,224,4,2021/02/20 05:00:00+00,220,2022/10/09 10:17:00+00,41
45,439,7,2021/02/20 05:00:00+00,432,2022/10/09 10:17:00+00,42
45,356,11,2021/02/27 05:00:00+00,345,2022/10/09 10:17:00+00,43
0,173,0,2021/03/06 05:00:00+00,173,2022/10/09 10:17:00+00,44
0,135,0,2021/03/13 05:00:00+00,135,2022/10/09 10:17:00+00,45
0,106,0,2021/03/20 04:00:00+00,106,2022/10/09 10:17:00+00,46
0,129,0,2021/03/27 04:00:00+00,129,2022/10/09 10:17:00+00,47
65,77,0,2021/03/27 04:00:00+00,77,2022/10/09 10:17:00+00,48
0,100,0,2021/04/03 04:00:00+00,100,2022/10/09 10:17:00+00,49
65,58,0,2021/04/03 04:00:00+00,58,2022/10/09 10:17:00+00,50
45,742,0,2022/05/14 04:00:00+00,742,2022/10/09 10:17:00+00,51
0,431,0,2022/05/28 04:00:00+00,431,2022/10/09 10:17:00+00,52
0,370,0,2022/06/04 04:00:00+00,370,2022/10/09 10:17:00+00,53
65,414,0,2022/06/04 04:00:00+00,414,2022/10/09 10:17:00+00,54
65,479,0,2022/06/11 04:00:00+00,479,2022/10/09 10:17:00+00,55
0,271,0,2022/06/18 04:00:00+00,271,2022/10/09 10:17:00+00,56
20,958,0,2022/06/18 04:00:00+00,958,2022/10/09 10:17:00+00,57
0,394,0,2022/07/09 04:00:00+00,394,2022/10/09 10:17:00+00,58
20,946,0,2022/07/09 04:00:00+00,946,2022/10/09 10:17:00+00,59
45,805,0,2022/07/16 04:00:00+00,805,2022/10/09 10:17:00+00,60
45,799,0,2022/07/23 04:00:00+00,799,2022/10/09 10:17:00+00,61
0,456,0,2022/08/06 04:00:00+00,456,2022/10/09 10:17:00+00,62
65,395,0,2022/08/27 04:00:00+00,395,2022/10/09 10:17:00+00,63
20,485,0,2022/09/10 04:00:00+00,485,2022/10/09 10:17:00+00,64
0,229,0,2022/09/17 04:00:00+00,229,2022/10/09 10:17:00+00,65
0,181,0,2022/09/24 04:00:00+00,181,2022/10/09 10:17:00+00,66
0,146,0,2022/10/01 04:00:00+00,146,2022/10/09 10:17:00+00,67
45,7,0,2020/03/21 04:00:00+00,7,2022/10/09 10:17:00+00,68
65,10,0,2020/03/21 04:00:00+00,10,2022/10/09 10:17:00+00,69
65,33,3,2020/03/28 04:00:00+00,30,2022/10/09 10:17:00+00,70
0,5,0,2020/04/04 04:00:00+00,5,2022/10/09 10:17:00+00,71
65,91,70,2020/04/18 04:00:00+00,21,2022/10/09 10:17:00+00,72
45,92,18,2020/04/25 04:00:00+00,74,2022/10/09 10:17:00+00,73
0,6,0,2020/05/02 04:00:00+00,6,2022/10/09 10:17:00+00,74
45,80,1,2020/05/16 04:00:00+00,79,2022/10/09 10:17:00+00,75
65,47,17,2020/05/16 04:00:00+00,30,2022/10/09 10:17:00+00,76
20,202,4,2020/05/23 04:00:00+00,198,2022/10/09 10:17:00+00,77
65,51,22,2020/05/23 04:00:00+00,29,2022/10/09 10:17:00+00,78
0,36,2,2020/05/30 04:00:00+00,34,2022/10/09 10:17:00+00,79
20,135,4,2020/05/30 04:00:00+00,131,2022/10/09 10:17:00+00,80
0,49,2,2020/06/06 04:00:00+00,47,2022/10/09 10:17:00+00,81
45,116,10,2020/06/06 04:00:00+00,106,2022/10/09 10:17:00+00,82
20,162,1,2020/07/04 04:00:00+00,161,2022/10/09 10:17:00+00,83
45,98,14,2020/07/11 04:00:00+00,84,2022/10/09 10:17:00+00,84
45,169,10,2020/07/18 04:00:00+00,159,2022/10/09 10:17:00+00,85
0,189,8,2020/07/25 04:00:00+00,181,2022/10/09 10:17:00+00,86
20,668,9,2020/08/15 04:00:00+00,659,2022/10/09 10:17:00+00,87
45,402,12,2020/08/15 04:00:00+00,390,2022/10/09 10:17:00+00,88
45,331,17,2020/08/22 04:00:00+00,314,2022/10/09 10:17:00+00,89
45,245,29,2020/08/29 04:00:00+00,216,2022/10/09 10:17:00+00,90
65,154,25,2020/09/05 04:00:00+00,129,2022/10/09 10:17:00+00,91
20,344,16,2020/09/12 04:00:00+00,328,2022/10/09 10:17:00+00,92
0,127,4,2020/09/19 04:00:00+00,123,2022/10/09 10:17:00+00,93
0,194,20,2020/09/26 04:00:00+00,174,2022/10/09 10:17:00+00,94
0,243,9,2020/10/03 04:00:00+00,234,2022/10/09 10:17:00+00,95
65,191,45,2020/10/03 04:00:00+00,146,2022/10/09 10:17:00+00,96
0,279,3,2020/10/24 04:00:00+00,276,2022/10/09 10:17:00+00,97
20,957,10,2020/11/07 05:00:00+00,947,2022/10/09 10:17:00+00,98
0,543,6,2020/11/14 05:00:00+00,537,2022/10/09 10:17:00+00,99
45,836,25,2020/11/14 05:00:00+00,811,2022/10/09 10:17:00+00,100
45,70,1,2020/04/04 04:00:00+00,69,2022/10/09 10:17:00+00,101
45,91,5,2020/04/11 04:00:00+00,86,2022/10/09 10:17:00+00,102
20,60,6,2020/04/18 04:00:00+00,54,2022/10/09 10:17:00+00,103
45,83,22,2020/04/18 04:00:00+00,61,2022/10/09 10:17:00+00,104
65,78,58,2020/04/25 04:00:00+00,20,2022/10/09 10:17:00+00,105
20,115,9,2020/05/02 04:00:00+00,106,2022/10/09 10:17:00+00,106
45,119,11,2020/05/02 04:00:00+00,108,2022/10/09 10:17:00+00,107
20,101,0,2020/05/09 04:00:00+00,101,2022/10/09 10:17:00+00,108
45,95,3,2020/05/09 04:00:00+00,92,2022/10/09 10:17:00+00,109
45,99,5,2020/05/23 04:00:00+00,94,2022/10/09 10:17:00+00,110
65,100,76,2020/05/30 04:00:00+00,24,2022/10/09 10:17:00+00,111
65,76,45,2020/06/06 04:00:00+00,31,2022/10/09 10:17:00+00,112
0,57,0,2020/07/11 04:00:00+00,57,2022/10/09 10:17:00+00,113
65,73,39,2020/07/11 04:00:00+00,34,2022/10/09 10:17:00+00,114
0,98,1,2020/07/18 04:00:00+00,97,2022/10/09 10:17:00+00,115
20,280,8,2020/07/18 04:00:00+00,272,2022/10/09 10:17:00+00,116
20,536,5,2020/07/25 04:00:00+00,531,2022/10/09 10:17:00+00,117
45,273,5,2020/07/25 04:00:00+00,268,2022/10/09 10:17:00+00,118
0,219,4,2020/08/08 04:00:00+00,215,2022/10/09 10:17:00+00,119
45,322,24,2020/08/08 04:00:00+00,298,2022/10/09 10:17:00+00,120
0,255,9,2020/08/22 04:00:00+00,246,2022/10/09 10:17:00+00,121
20,550,10,2020/08/22 04:00:00+00,540,2022/10/09 10:17:00+00,122
20,462,85,2020/08/29 04:00:00+00,377,2022/10/09 10:17:00+00,123
65,115,22,2020/08/29 04:00:00+00,93,2022/10/09 10:17:00+00,124
20,579,64,2020/09/05 04:00:00+00,515,2022/10/09 10:17:00+00,125
0,164,4,2020/09/12 04:00:00+00,160,2022/10/09 10:17:00+00,126
65,136,34,2020/09/19 04:00:00+00,102,2022/10/09 10:17:00+00,127
20,497,12,2020/10/03 04:00:00+00,485,2022/10/09 10:17:00+00,128
45,332,9,2020/10/10 04:00:00+00,323,2022/10/09 10:17:00+00,129
65,219,49,2020/10/10 04:00:00+00,170,2022/10/09 10:17:00+00,130
45,662,6,2020/10/31 04:00:00+00,656,2022/10/09 10:17:00+00,131
65,347,40,2020/10/31 04:00:00+00,307,2022/10/09 10:17:00+00,132
0,285,4,2020/11/07 05:00:00+00,281,2022/10/09 10:17:00+00,133
45,655,12,2020/11/07 05:00:00+00,643,2022/10/09 10:17:00+00,134
20,1414,10,2020/11/14 05:00:00+00,1404,2022/10/09 10:17:00+00,135
45,962,11,2020/11/28 05:00:00+00,951,2022/10/09 10:17:00+00,136
45,1128,9,2020/12/05 05:00:00+00,1119,2022/10/09 10:17:00+00,137
20,988,3,2020/12/26 05:00:00+00,985,2022/10/09 10:17:00+00,138
45,697,5,2020/12/26 05:00:00+00,692,2022/10/09 10:17:00+00,139
20,1157,13,2021/01/02 05:00:00+00,1144,2022/10/09 10:17:00+00,140
45,1083,24,2021/01/09 05:00:00+00,1059,2022/10/09 10:17:00+00,141
20,1511,21,2021/01/16 05:00:00+00,1490,2022/10/09 10:17:00+00,142
20,1375,3,2021/01/23 05:00:00+00,1372,2022/10/09 10:17:00+00,143
20,1059,0,2021/01/30 05:00:00+00,1059,2022/10/09 10:17:00+00,144
20,823,2,2021/02/06 05:00:00+00,821,2022/10/09 10:17:00+00,145
0,308,2,2021/02/13 05:00:00+00,306,2022/10/09 10:17:00+00,146
20,825,3,2021/02/13 05:00:00+00,822,2022/10/09 10:17:00+00,147
65,317,24,2021/02/13 05:00:00+00,293,2022/10/09 10:17:00+00,148
20,592,5,2021/02/20 05:00:00+00,587,2022/10/09 10:17:00+00,149
0,196,2,2021/02/27 05:00:00+00,194,2022/10/09 10:17:00+00,150
0,146,0,2021/04/24 04:00:00+00,146,2022/10/09 10:17:00+00,151
0,156,0,2021/05/08 04:00:00+00,156,2022/10/09 10:17:00+00,152
20,313,0,2021/05/08 04:00:00+00,313,2022/10/09 10:17:00+00,153
65,43,0,2021/05/15 04:00:00+00,43,2022/10/09 10:17:00+00,154
20,79,0,2021/06/05 04:00:00+00,79,2022/10/09 10:17:00+00,155
65,12,0,2021/06/05 04:00:00+00,12,2022/10/09 10:17:00+00,156
45,45,0,2021/06/12 04:00:00+00,45,2022/10/09 10:17:00+00,157
0,42,0,2021/06/19 04:00:00+00,42,2022/10/09 10:17:00+00,158
45,39,0,2021/06/19 04:00:00+00,39,2022/10/09 10:17:00+00,159
0,36,0,2021/06/26 04:00:00+00,36,2022/10/09 10:17:00+00,160
45,39,0,2021/07/03 04:00:00+00,39,2022/10/09 10:17:00+00,161
45,56,0,2021/07/10 04:00:00+00,56,2022/10/09 10:17:00+00,162
0,88,0,2021/07/17 04:00:00+00,88,2022/10/09 10:17:00+00,163
45,236,0,2021/07/31 04:00:00+00,236,2022/10/09 10:17:00+00,164
65,107,0,2021/07/31 04:00:00+00,107,2022/10/09 10:17:00+00,165
0,423,0,2021/08/07 04:00:00+00,423,2022/10/09 10:17:00+00,166
20,1255,0,2021/08/21 04:00:00+00,1255,2022/10/09 10:17:00+00,167
0,797,0,2021/09/11 04:00:00+00,797,2022/10/09 10:17:00+00,168
20,903,0,2021/09/25 04:00:00+00,903,2022/10/09 10:17:00+00,169
20,836,0,2021/10/02 04:00:00+00,836,2022/10/09 10:17:00+00,170
45,451,0,2021/10/02 04:00:00+00,451,2022/10/09 10:17:00+00,171
20,958,0,2021/10/09 04:00:00+00,958,2022/10/09 10:17:00+00,172
65,238,0,2021/10/09 04:00:00+00,238,2022/10/09 10:17:00+00,173
45,297,0,2021/10/23 04:00:00+00,297,2022/10/09 10:17:00+00,174
20,345,0,2021/10/30 04:00:00+00,345,2022/10/09 10:17:00+00,175
45,217,0,2021/10/30 04:00:00+00,217,2022/10/09 10:17:00+00,176
65,140,0,2021/11/13 05:00:00+00,140,2022/10/09 10:17:00+00,177
0,356,0,2021/11/20 05:00:00+00,356,2022/10/09 10:17:00+00,178
45,334,0,2021/11/20 05:00:00+00,334,2022/10/09 10:17:00+00,179
45,292,0,2021/11/27 05:00:00+00,292,2022/10/09 10:17:00+00,180
45,501,0,2021/12/04 05:00:00+00,501,2022/10/09 10:17:00+00,181
65,215,0,2021/12/04 05:00:00+00,215,2022/10/09 10:17:00+00,182
20,848,0,2021/12/11 05:00:00+00,848,2022/10/09 10:17:00+00,183
20,752,0,2021/12/18 05:00:00+00,752,2022/10/09 10:17:00+00,184
20,4740,0,2022/01/01 05:00:00+00,4740,2022/10/09 10:17:00+00,185
65,1566,0,2022/01/15 05:00:00+00,1566,2022/10/09 10:17:00+00,186
0,3093,0,2022/01/22 05:00:00+00,3093,2022/10/09 10:17:00+00,187
20,5901,0,2022/01/22 05:00:00+00,5901,2022/10/09 10:17:00+00,188
65,1508,0,2022/01/22 05:00:00+00,1508,2022/10/09 10:17:00+00,189
65,705,0,2022/02/05 05:00:00+00,705,2022/10/09 10:17:00+00,190
20,2132,0,2022/02/12 05:00:00+00,2132,2022/10/09 10:17:00+00,191
65,596,0,2022/02/12 05:00:00+00,596,2022/10/09 10:17:00+00,192
20,581,0,2022/02/26 05:00:00+00,581,2022/10/09 10:17:00+00,193
45,232,0,2022/03/05 05:00:00+00,232,2022/10/09 10:17:00+00,194
45,380,0,2022/03/19 04:00:00+00,380,2022/10/09 10:17:00+00,195
0,152,0,2022/03/26 04:00:00+00,152,2022/10/09 10:17:00+00,196
20,142,0,2022/03/26 04:00:00+00,142,2022/10/09 10:17:00+00,197
0,2,0,2020/03/21 04:00:00+00,2,2022/10/09 10:17:00+00,198
20,1,0,2020/03/21 04:00:00+00,1,2022/10/09 10:17:00+00,199
20,32,0,2020/03/28 04:00:00+00,32,2022/10/09 10:17:00+00,200
65,150,10,2021/02/27 05:00:00+00,140,2022/10/09 10:17:00+00,201
45,294,2,2021/03/06 05:00:00+00,292,2022/10/09 10:17:00+00,202
65,93,0,2021/03/13 05:00:00+00,93,2022/10/09 10:17:00+00,203
0,164,0,2021/04/17 04:00:00+00,164,2022/10/09 10:17:00+00,204
45,164,0,2021/04/17 04:00:00+00,164,2022/10/09 10:17:00+00,205
65,51,0,2021/04/17 04:00:00+00,51,2022/10/09 10:17:00+00,206
45,134,0,2021/04/24 04:00:00+00,134,2022/10/09 10:17:00+00,207
0,164,0,2021/05/22 04:00:00+00,164,2022/10/09 10:17:00+00,208
65,41,0,2021/05/22 04:00:00+00,41,2022/10/09 10:17:00+00,209
65,21,0,2021/06/12 04:00:00+00,21,2022/10/09 10:17:00+00,210
65,18,0,2021/06/26 04:00:00+00,18,2022/10/09 10:17:00+00,211
65,17,0,2021/07/03 04:00:00+00,17,2022/10/09 10:17:00+00,212
65,22,0,2021/07/10 04:00:00+00,22,2022/10/09 10:17:00+00,213
45,89,0,2021/07/17 04:00:00+00,89,2022/10/09 10:17:00+00,214
65,37,0,2021/07/17 04:00:00+00,37,2022/10/09 10:17:00+00,215
20,331,0,2021/07/24 04:00:00+00,331,2022/10/09 10:17:00+00,216
45,123,0,2021/07/24 04:00:00+00,123,2022/10/09 10:17:00+00,217
20,545,0,2021/07/31 04:00:00+00,545,2022/10/09 10:17:00+00,218
20,810,0,2021/08/07 04:00:00+00,810,2022/10/09 10:17:00+00,219
0,501,0,2021/08/14 04:00:00+00,501,2022/10/09 10:17:00+00,220
20,905,0,2021/08/14 04:00:00+00,905,2022/10/09 10:17:00+00,221
65,306,0,2021/08/21 04:00:00+00,306,2022/10/09 10:17:00+00,222
20,1446,0,2021/08/28 04:00:00+00,1446,2022/10/09 10:17:00+00,223
45,714,0,2021/08/28 04:00:00+00,714,2022/10/09 10:17:00+00,224
20,1290,0,2021/09/04 04:00:00+00,1290,2022/10/09 10:17:00+00,225
20,1112,0,2021/09/11 04:00:00+00,1112,2022/10/09 10:17:00+00,226
45,729,0,2021/09/18 04:00:00+00,729,2022/10/09 10:17:00+00,227
65,352,0,2021/09/18 04:00:00+00,352,2022/10/09 10:17:00+00,228
0,715,0,2021/09/25 04:00:00+00,715,2022/10/09 10:17:00+00,229
45,480,0,2021/09/25 04:00:00+00,480,2022/10/09 10:17:00+00,230
0,754,0,2021/10/09 04:00:00+00,754,2022/10/09 10:17:00+00,231
20,617,0,2021/10/16 04:00:00+00,617,2022/10/09 10:17:00+00,232
45,325,0,2021/10/16 04:00:00+00,325,2022/10/09 10:17:00+00,233
65,177,0,2021/10/16 04:00:00+00,177,2022/10/09 10:17:00+00,234
45,350,0,2021/11/06 04:00:00+00,350,2022/10/09 10:17:00+00,235
0,365,0,2021/11/13 05:00:00+00,365,2022/10/09 10:17:00+00,236
20,499,0,2021/11/13 05:00:00+00,499,2022/10/09 10:17:00+00,237
0,256,0,2021/11/27 05:00:00+00,256,2022/10/09 10:17:00+00,238
20,471,0,2021/11/27 05:00:00+00,471,2022/10/09 10:17:00+00,239
0,557,0,2021/12/04 05:00:00+00,557,2022/10/09 10:17:00+00,240
45,442,0,2021/12/18 05:00:00+00,442,2022/10/09 10:17:00+00,241
65,282,0,2021/12/25 05:00:00+00,282,2022/10/09 10:17:00+00,242
0,1888,0,2022/01/01 05:00:00+00,1888,2022/10/09 10:17:00+00,243
45,2367,0,2022/01/01 05:00:00+00,2367,2022/10/09 10:17:00+00,244
0,95,0,2022/04/09 04:00:00+00,95,2022/10/09 10:17:00+00,245
45,114,0,2022/04/09 04:00:00+00,114,2022/10/09 10:17:00+00,246
65,78,0,2022/04/09 04:00:00+00,78,2022/10/09 10:17:00+00,247
45,214,0,2022/04/16 04:00:00+00,214,2022/10/09 10:17:00+00,248
45,227,0,2022/04/23 04:00:00+00,227,2022/10/09 10:17:00+00,249
0,404,0,2022/04/30 04:00:00+00,404,2022/10/09 10:17:00+00,250
0,603,0,2022/08/20 04:00:00+00,603,2022/10/09 10:17:00+00,251
45,549,0,2022/08/20 04:00:00+00,549,2022/10/09 10:17:00+00,252
0,657,0,2022/08/27 04:00:00+00,657,2022/10/09 10:17:00+00,253
45,472,0,2022/09/03 04:00:00+00,472,2022/10/09 10:17:00+00,254
45,365,0,2022/09/10 04:00:00+00,365,2022/10/09 10:17:00+00,255
65,209,0,2022/10/01 04:00:00+00,209,2022/10/09 10:17:00+00,256
20,667,0,2022/03/19 04:00:00+00,667,2022/10/09 10:17:00+00,257
20,176,0,2022/04/02 04:00:00+00,176,2022/10/09 10:17:00+00,258
65,73,0,2022/04/02 04:00:00+00,73,2022/10/09 10:17:00+00,259
0,161,0,2022/04/16 04:00:00+00,161,2022/10/09 10:17:00+00,260
20,295,0,2022/04/16 04:00:00+00,295,2022/10/09 10:17:00+00,261
20,579,0,2022/05/07 04:00:00+00,579,2022/10/09 10:17:00+00,262
45,448,0,2022/05/07 04:00:00+00,448,2022/10/09 10:17:00+00,263
0,615,0,2022/05/14 04:00:00+00,615,2022/10/09 10:17:00+00,264
20,1244,0,2022/05/14 04:00:00+00,1244,2022/10/09 10:17:00+00,265
0,615,0,2022/05/21 04:00:00+00,615,2022/10/09 10:17:00+00,266
20,1514,0,2022/05/21 04:00:00+00,1514,2022/10/09 10:17:00+00,267
45,1023,0,2022/05/21 04:00:00+00,1023,2022/10/09 10:17:00+00,268
65,377,0,2022/05/28 04:00:00+00,377,2022/10/09 10:17:00+00,269
45,687,0,2022/06/11 04:00:00+00,687,2022/10/09 10:17:00+00,270
45,668,0,2022/06/18 04:00:00+00,668,2022/10/09 10:17:00+00,271
20,960,0,2022/07/02 04:00:00+00,960,2022/10/09 10:17:00+00,272
45,636,0,2022/07/09 04:00:00+00,636,2022/10/09 10:17:00+00,273
65,388,0,2022/07/09 04:00:00+00,388,2022/10/09 10:17:00+00,274
65,578,0,2022/07/16 04:00:00+00,578,2022/10/09 10:17:00+00,275
0,473,0,2022/07/23 04:00:00+00,473,2022/10/09 10:17:00+00,276
65,524,0,2022/07/23 04:00:00+00,524,2022/10/09 10:17:00+00,277
0,502,0,2022/07/30 04:00:00+00,502,2022/10/09 10:17:00+00,278
20,1163,0,2022/07/30 04:00:00+00,1163,2022/10/09 10:17:00+00,279
65,559,0,2022/07/30 04:00:00+00,559,2022/10/09 10:17:00+00,280
45,702,0,2022/08/06 04:00:00+00,702,2022/10/09 10:17:00+00,281
20,836,0,2022/08/13 04:00:00+00,836,2022/10/09 10:17:00+00,282
45,654,0,2022/08/13 04:00:00+00,654,2022/10/09 10:17:00+00,283
20,779,0,2022/08/27 04:00:00+00,779,2022/10/09 10:17:00+00,284
45,590,0,2022/08/27 04:00:00+00,590,2022/10/09 10:17:00+00,285
0,552,0,2022/09/03 04:00:00+00,552,2022/10/09 10:17:00+00,286
65,416,0,2022/09/03 04:00:00+00,416,2022/10/09 10:17:00+00,287
0,301,0,2022/09/10 04:00:00+00,301,2022/10/09 10:17:00+00,288
45,266,0,2022/09/17 04:00:00+00,266,2022/10/09 10:17:00+00,289
20,330,0,2022/09/24 04:00:00+00,330,2022/10/09 10:17:00+00,290
45,260,0,2022/09/24 04:00:00+00,260,2022/10/09 10:17:00+00,291
65,243,0,2022/09/24 04:00:00+00,243,2022/10/09 10:17:00+00,292
20,340,0,2022/10/01 04:00:00+00,340,2022/10/09 10:17:00+00,293
45,273,0,2022/10/01 04:00:00+00,273,2022/10/09 10:17:00+00,294
0,119,0,2022/10/08 04:00:00+00,119,2022/10/09 10:17:00+00,295
45,251,0,2022/10/08 04:00:00+00,251,2022/10/09 10:17:00+00,296
65,176,0,2022/10/08 04:00:00+00,176,2022/10/09 10:17:00+00,297
45,47,0,2020/03/28 04:00:00+00,47,2022/10/09 10:17:00+00,298
65,58,12,2020/04/04 04:00:00+00,46,2022/10/09 10:17:00+00,299
20,47,4,2020/04/11 04:00:00+00,43,2022/10/09 10:17:00+00,300
65,456,71,2020/11/14 05:00:00+00,385,2022/10/09 10:17:00+00,301
20,1478,10,2020/11/21 05:00:00+00,1468,2022/10/09 10:17:00+00,302
65,482,60,2020/11/21 05:00:00+00,422,2022/10/09 10:17:00+00,303
0,505,3,2020/11/28 05:00:00+00,502,2022/10/09 10:17:00+00,304
65,485,30,2020/11/28 05:00:00+00,455,2022/10/09 10:17:00+00,305
20,1408,9,2020/12/12 05:00:00+00,1399,2022/10/09 10:17:00+00,306
0,355,4,2020/12/19 05:00:00+00,351,2022/10/09 10:17:00+00,307
65,396,51,2020/12/19 05:00:00+00,345,2022/10/09 10:17:00+00,308
0,542,5,2021/01/09 05:00:00+00,537,2022/10/09 10:17:00+00,309
65,522,70,2021/01/09 05:00:00+00,452,2022/10/09 10:17:00+00,310
0,475,6,2021/01/16 05:00:00+00,469,2022/10/09 10:17:00+00,311
65,532,65,2021/01/16 05:00:00+00,467,2022/10/09 10:17:00+00,312
0,318,2,2021/02/06 05:00:00+00,316,2022/10/09 10:17:00+00,313
65,103,1,2021/03/06 05:00:00+00,102,2022/10/09 10:17:00+00,314
20,329,0,2021/03/27 04:00:00+00,329,2022/10/09 10:17:00+00,315
45,172,0,2021/03/27 04:00:00+00,172,2022/10/09 10:17:00+00,316
0,128,0,2021/04/10 04:00:00+00,128,2022/10/09 10:17:00+00,317
45,166,0,2021/04/10 04:00:00+00,166,2022/10/09 10:17:00+00,318
65,56,0,2021/04/10 04:00:00+00,56,2022/10/09 10:17:00+00,319
20,256,0,2021/04/24 04:00:00+00,256,2022/10/09 10:17:00+00,320
65,34,0,2021/04/24 04:00:00+00,34,2022/10/09 10:17:00+00,321
20,382,0,2021/05/01 04:00:00+00,382,2022/10/09 10:17:00+00,322
65,60,0,2021/05/01 04:00:00+00,60,2022/10/09 10:17:00+00,323
65,54,0,2021/05/08 04:00:00+00,54,2022/10/09 10:17:00+00,324
0,113,0,2021/05/15 04:00:00+00,113,2022/10/09 10:17:00+00,325
20,254,0,2021/05/15 04:00:00+00,254,2022/10/09 10:17:00+00,326
0,88,0,2021/05/29 04:00:00+00,88,2022/10/09 10:17:00+00,327
65,36,0,2021/05/29 04:00:00+00,36,2022/10/09 10:17:00+00,328
0,43,0,2021/06/05 04:00:00+00,43,2022/10/09 10:17:00+00,329
45,46,0,2021/06/05 04:00:00+00,46,2022/10/09 10:17:00+00,330
20,69,0,2021/06/19 04:00:00+00,69,2022/10/09 10:17:00+00,331
45,31,0,2021/06/26 04:00:00+00,31,2022/10/09 10:17:00+00,332
20,79,0,2021/07/03 04:00:00+00,79,2022/10/09 10:17:00+00,333
0,35,0,2021/07/10 04:00:00+00,35,2022/10/09 10:17:00+00,334
20,179,0,2021/07/17 04:00:00+00,179,2022/10/09 10:17:00+00,335
0,141,0,2021/07/24 04:00:00+00,141,2022/10/09 10:17:00+00,336
0,299,0,2021/07/31 04:00:00+00,299,2022/10/09 10:17:00+00,337
45,415,0,2021/08/07 04:00:00+00,415,2022/10/09 10:17:00+00,338
65,183,0,2021/08/07 04:00:00+00,183,2022/10/09 10:17:00+00,339
0,936,0,2021/08/21 04:00:00+00,936,2022/10/09 10:17:00+00,340
65,344,0,2021/08/28 04:00:00+00,344,2022/10/09 10:17:00+00,341
0,1126,0,2021/09/04 04:00:00+00,1126,2022/10/09 10:17:00+00,342
45,673,0,2021/09/04 04:00:00+00,673,2022/10/09 10:17:00+00,343
45,593,0,2021/09/11 04:00:00+00,593,2022/10/09 10:17:00+00,344
20,1370,0,2021/09/18 04:00:00+00,1370,2022/10/09 10:17:00+00,345
0,610,0,2021/10/02 04:00:00+00,610,2022/10/09 10:17:00+00,346
0,440,0,2021/10/23 04:00:00+00,440,2022/10/09 10:17:00+00,347
20,601,0,2021/11/06 04:00:00+00,601,2022/10/09 10:17:00+00,348
65,167,0,2021/11/06 04:00:00+00,167,2022/10/09 10:17:00+00,349
45,303,0,2021/11/13 05:00:00+00,303,2022/10/09 10:17:00+00,350
65,187,0,2021/11/27 05:00:00+00,187,2022/10/09 10:17:00+00,351
0,497,0,2021/12/11 05:00:00+00,497,2022/10/09 10:17:00+00,352
45,490,0,2021/12/11 05:00:00+00,490,2022/10/09 10:17:00+00,353
0,603,0,2021/12/25 05:00:00+00,603,2022/10/09 10:17:00+00,354
45,693,0,2021/12/25 05:00:00+00,693,2022/10/09 10:17:00+00,355
0,3785,0,2022/01/08 05:00:00+00,3785,2022/10/09 10:17:00+00,356
20,7277,0,2022/01/08 05:00:00+00,7277,2022/10/09 10:17:00+00,357
45,3634,0,2022/01/08 05:00:00+00,3634,2022/10/09 10:17:00+00,358
20,6962,0,2022/01/15 05:00:00+00,6962,2022/10/09 10:17:00+00,359
45,2616,0,2022/01/29 05:00:00+00,2616,2022/10/09 10:17:00+00,360
45,1277,0,2022/02/12 05:00:00+00,1277,2022/10/09 10:17:00+00,361
0,2604,0,2022/02/19 05:00:00+00,2604,2022/10/09 10:17:00+00,362
20,2539,0,2022/02/19 05:00:00+00,2539,2022/10/09 10:17:00+00,363
45,221,0,2022/03/12 05:00:00+00,221,2022/10/09 10:17:00+00,364
65,785,0,2022/01/01 05:00:00+00,785,2022/10/09 10:17:00+00,365
65,1356,0,2022/01/08 05:00:00+00,1356,2022/10/09 10:17:00+00,366
0,2731,0,2022/01/29 05:00:00+00,2731,2022/10/09 10:17:00+00,367
20,4279,0,2022/01/29 05:00:00+00,4279,2022/10/09 10:17:00+00,368
65,1275,0,2022/01/29 05:00:00+00,1275,2022/10/09 10:17:00+00,369
0,1782,0,2022/02/05 05:00:00+00,1782,2022/10/09 10:17:00+00,370
20,2173,0,2022/02/05 05:00:00+00,2173,2022/10/09 10:17:00+00,371
45,1361,0,2022/02/05 05:00:00+00,1361,2022/10/09 10:17:00+00,372
0,1629,0,2022/02/12 05:00:00+00,1629,2022/10/09 10:17:00+00,373
0,390,0,2022/02/26 05:00:00+00,390,2022/10/09 10:17:00+00,374
45,399,0,2022/02/26 05:00:00+00,399,2022/10/09 10:17:00+00,375
65,251,0,2022/02/26 05:00:00+00,251,2022/10/09 10:17:00+00,376
0,314,0,2022/03/05 05:00:00+00,314,2022/10/09 10:17:00+00,377
20,368,0,2022/03/05 05:00:00+00,368,2022/10/09 10:17:00+00,378
20,338,0,2022/03/12 05:00:00+00,338,2022/10/09 10:17:00+00,379
0,668,0,2022/03/19 04:00:00+00,668,2022/10/09 10:17:00+00,380
0,113,0,2022/04/02 04:00:00+00,113,2022/10/09 10:17:00+00,381
20,175,0,2022/04/09 04:00:00+00,175,2022/10/09 10:17:00+00,382
0,180,0,2022/04/23 04:00:00+00,180,2022/10/09 10:17:00+00,383
20,301,0,2022/04/23 04:00:00+00,301,2022/10/09 10:17:00+00,384
45,339,0,2022/04/30 04:00:00+00,339,2022/10/09 10:17:00+00,385
65,226,0,2022/04/30 04:00:00+00,226,2022/10/09 10:17:00+00,386
0,489,0,2022/05/07 04:00:00+00,489,2022/10/09 10:17:00+00,387
65,400,0,2022/05/14 04:00:00+00,400,2022/10/09 10:17:00+00,388
65,575,0,2022/05/21 04:00:00+00,575,2022/10/09 10:17:00+00,389
20,802,0,2022/05/28 04:00:00+00,802,2022/10/09 10:17:00+00,390
45,587,0,2022/05/28 04:00:00+00,587,2022/10/09 10:17:00+00,391
0,337,0,2022/06/11 04:00:00+00,337,2022/10/09 10:17:00+00,392
65,412,0,2022/06/18 04:00:00+00,412,2022/10/09 10:17:00+00,393
0,314,0,2022/07/02 04:00:00+00,314,2022/10/09 10:17:00+00,394
65,451,0,2022/07/02 04:00:00+00,451,2022/10/09 10:17:00+00,395
20,1220,0,2022/07/16 04:00:00+00,1220,2022/10/09 10:17:00+00,396
20,1064,0,2022/07/23 04:00:00+00,1064,2022/10/09 10:17:00+00,397
20,988,0,2022/08/06 04:00:00+00,988,2022/10/09 10:17:00+00,398
65,496,0,2022/08/06 04:00:00+00,496,2022/10/09 10:17:00+00,399
65,440,0,2022/08/13 04:00:00+00,440,2022/10/09 10:17:00+00,400
45,117,0,2021/05/22 04:00:00+00,117,2022/10/09 10:17:00+00,401
20,170,0,2021/05/29 04:00:00+00,170,2022/10/09 10:17:00+00,402
45,74,0,2021/05/29 04:00:00+00,74,2022/10/09 10:17:00+00,403
0,52,0,2021/06/12 04:00:00+00,52,2022/10/09 10:17:00+00,404
20,103,0,2021/06/12 04:00:00+00,103,2022/10/09 10:17:00+00,405
65,15,0,2021/06/19 04:00:00+00,15,2022/10/09 10:17:00+00,406
20,71,0,2021/06/26 04:00:00+00,71,2022/10/09 10:17:00+00,407
0,61,0,2021/07/03 04:00:00+00,61,2022/10/09 10:17:00+00,408
20,104,0,2021/07/10 04:00:00+00,104,2022/10/09 10:17:00+00,409
65,56,0,2021/07/24 04:00:00+00,56,2022/10/09 10:17:00+00,410
45,461,0,2021/08/14 04:00:00+00,461,2022/10/09 10:17:00+00,411
65,248,0,2021/08/14 04:00:00+00,248,2022/10/09 10:17:00+00,412
65,76,28,2020/04/11 04:00:00+00,48,2022/10/09 10:17:00+00,413
45,585,0,2021/08/21 04:00:00+00,585,2022/10/09 10:17:00+00,414
0,1165,0,2021/08/28 04:00:00+00,1165,2022/10/09 10:17:00+00,415
65,337,0,2021/09/04 04:00:00+00,337,2022/10/09 10:17:00+00,416
65,304,0,2021/09/11 04:00:00+00,304,2022/10/09 10:17:00+00,417
0,1036,0,2021/09/18 04:00:00+00,1036,2022/10/09 10:17:00+00,418
65,285,0,2021/09/25 04:00:00+00,285,2022/10/09 10:17:00+00,419
65,239,0,2021/10/02 04:00:00+00,239,2022/10/09 10:17:00+00,420
45,508,0,2021/10/09 04:00:00+00,508,2022/10/09 10:17:00+00,421
0,597,0,2021/10/16 04:00:00+00,597,2022/10/09 10:17:00+00,422
20,511,0,2021/10/23 04:00:00+00,511,2022/10/09 10:17:00+00,423
65,151,0,2021/10/23 04:00:00+00,151,2022/10/09 10:17:00+00,424
0,295,0,2021/10/30 04:00:00+00,295,2022/10/09 10:17:00+00,425
65,86,0,2021/10/30 04:00:00+00,86,2022/10/09 10:17:00+00,426
0,458,0,2021/11/06 04:00:00+00,458,2022/10/09 10:17:00+00,427
20,551,0,2021/11/20 05:00:00+00,551,2022/10/09 10:17:00+00,428
65,136,0,2021/11/20 05:00:00+00,136,2022/10/09 10:17:00+00,429
20,837,0,2021/12/04 05:00:00+00,837,2022/10/09 10:17:00+00,430
65,209,0,2021/12/11 05:00:00+00,209,2022/10/09 10:17:00+00,431
0,511,0,2021/12/18 05:00:00+00,511,2022/10/09 10:17:00+00,432
65,237,0,2021/12/18 05:00:00+00,237,2022/10/09 10:17:00+00,433
20,1514,0,2021/12/25 05:00:00+00,1514,2022/10/09 10:17:00+00,434
0,3320,0,2022/01/15 05:00:00+00,3320,2022/10/09 10:17:00+00,435
45,3947,0,2022/01/15 05:00:00+00,3947,2022/10/09 10:17:00+00,436
45,3354,0,2022/01/22 05:00:00+00,3354,2022/10/09 10:17:00+00,437
45,1334,0,2022/02/19 05:00:00+00,1334,2022/10/09 10:17:00+00,438
65,488,0,2022/02/19 05:00:00+00,488,2022/10/09 10:17:00+00,439
65,190,0,2022/03/05 05:00:00+00,190,2022/10/09 10:17:00+00,440
0,334,0,2022/03/12 05:00:00+00,334,2022/10/09 10:17:00+00,441
65,147,0,2022/03/12 05:00:00+00,147,2022/10/09 10:17:00+00,442
65,149,0,2022/03/19 04:00:00+00,149,2022/10/09 10:17:00+00,443
45,100,0,2022/03/26 04:00:00+00,100,2022/10/09 10:17:00+00,444
65,77,0,2022/03/26 04:00:00+00,77,2022/10/09 10:17:00+00,445
45,105,0,2022/04/02 04:00:00+00,105,2022/10/09 10:17:00+00,446
65,137,0,2022/04/16 04:00:00+00,137,2022/10/09 10:17:00+00,447
65,145,0,2022/04/23 04:00:00+00,145,2022/10/09 10:17:00+00,448
20,414,0,2022/04/30 04:00:00+00,414,2022/10/09 10:17:00+00,449
65,242,0,2022/05/07 04:00:00+00,242,2022/10/09 10:17:00+00,450
20,876,0,2022/06/04 04:00:00+00,876,2022/10/09 10:17:00+00,451
45,633,0,2022/06/04 04:00:00+00,633,2022/10/09 10:17:00+00,452
20,987,0,2022/06/11 04:00:00+00,987,2022/10/09 10:17:00+00,453
0,378,0,2022/06/25 04:00:00+00,378,2022/10/09 10:17:00+00,454
20,1087,0,2022/06/25 04:00:00+00,1087,2022/10/09 10:17:00+00,455
45,715,0,2022/06/25 04:00:00+00,715,2022/10/09 10:17:00+00,456
65,448,0,2022/06/25 04:00:00+00,448,2022/10/09 10:17:00+00,457
45,618,0,2022/07/02 04:00:00+00,618,2022/10/09 10:17:00+00,458
0,461,0,2022/07/16 04:00:00+00,461,2022/10/09 10:17:00+00,459
45,770,0,2022/07/30 04:00:00+00,770,2022/10/09 10:17:00+00,460
0,468,0,2022/08/13 04:00:00+00,468,2022/10/09 10:17:00+00,461
20,861,0,2022/08/20 04:00:00+00,861,2022/10/09 10:17:00+00,462
65,402,0,2022/08/20 04:00:00+00,402,2022/10/09 10:17:00+00,463
20,733,0,2022/09/03 04:00:00+00,733,2022/10/09 10:17:00+00,464
65,301,0,2022/09/10 04:00:00+00,301,2022/10/09 10:17:00+00,465
20,422,0,2022/09/17 04:00:00+00,422,2022/10/09 10:17:00+00,466
65,258,0,2022/09/17 04:00:00+00,258,2022/10/09 10:17:00+00,467
20,293,0,2022/10/08 04:00:00+00,293,2022/10/09 10:17:00+00,468
0,1,0,2020/04/18 04:00:00+00,1,2022/10/09 10:17:00+00,469
0,10,2,2020/05/09 04:00:00+00,8,2022/10/09 10:17:00+00,470
20,130,4,2020/05/16 04:00:00+00,126,2022/10/09 10:17:00+00,471
0,33,11,2020/05/23 04:00:00+00,22,2022/10/09 10:17:00+00,472
45,102,16,2020/05/30 04:00:00+00,86,2022/10/09 10:17:00+00,473
45,93,11,2020/06/13 04:00:00+00,82,2022/10/09 10:17:00+00,474
0,28,0,2020/06/20 04:00:00+00,28,2022/10/09 10:17:00+00,475
45,73,7,2020/06/20 04:00:00+00,66,2022/10/09 10:17:00+00,476
65,46,28,2020/06/20 04:00:00+00,18,2022/10/09 10:17:00+00,477
0,33,0,2020/06/27 04:00:00+00,33,2022/10/09 10:17:00+00,478
20,125,4,2020/06/27 04:00:00+00,121,2022/10/09 10:17:00+00,479
0,31,0,2020/07/04 04:00:00+00,31,2022/10/09 10:17:00+00,480
45,86,3,2020/07/04 04:00:00+00,83,2022/10/09 10:17:00+00,481
20,216,3,2020/07/11 04:00:00+00,213,2022/10/09 10:17:00+00,482
65,102,50,2020/07/18 04:00:00+00,52,2022/10/09 10:17:00+00,483
65,113,24,2020/07/25 04:00:00+00,89,2022/10/09 10:17:00+00,484
0,196,14,2020/08/01 04:00:00+00,182,2022/10/09 10:17:00+00,485
45,251,4,2020/08/01 04:00:00+00,247,2022/10/09 10:17:00+00,486
65,122,18,2020/08/01 04:00:00+00,104,2022/10/09 10:17:00+00,487
0,300,4,2020/08/15 04:00:00+00,296,2022/10/09 10:17:00+00,488
65,161,30,2020/08/15 04:00:00+00,131,2022/10/09 10:17:00+00,489
65,198,45,2020/08/22 04:00:00+00,153,2022/10/09 10:17:00+00,490
0,251,9,2020/09/05 04:00:00+00,242,2022/10/09 10:17:00+00,491
45,347,27,2020/09/05 04:00:00+00,320,2022/10/09 10:17:00+00,492
20,315,7,2020/09/19 04:00:00+00,308,2022/10/09 10:17:00+00,493
20,432,5,2020/09/26 04:00:00+00,427,2022/10/09 10:17:00+00,494
45,285,9,2020/09/26 04:00:00+00,276,2022/10/09 10:17:00+00,495
65,156,46,2020/09/26 04:00:00+00,110,2022/10/09 10:17:00+00,496
45,364,8,2020/10/03 04:00:00+00,356,2022/10/09 10:17:00+00,497
20,487,5,2020/10/10 04:00:00+00,482,2022/10/09 10:17:00+00,498
0,233,4,2020/10/17 04:00:00+00,229,2022/10/09 10:17:00+00,499
20,566,4,2020/10/17 04:00:00+00,562,2022/10/09 10:17:00+00,500
20,690,3,2020/10/24 04:00:00+00,687,2022/10/09 10:17:00+00,501
45,572,8,2020/10/24 04:00:00+00,564,2022/10/09 10:17:00+00,502
65,327,71,2020/10/24 04:00:00+00,256,2022/10/09 10:17:00+00,503
20,1004,5,2020/10/31 04:00:00+00,999,2022/10/09 10:17:00+00,504
65,344,58,2020/11/07 05:00:00+00,286,2022/10/09 10:17:00+00,505
45,972,14,2020/11/21 05:00:00+00,958,2022/10/09 10:17:00+00,506
20,1477,10,2020/11/28 05:00:00+00,1467,2022/10/09 10:17:00+00,507
0,529,7,2020/12/05 05:00:00+00,522,2022/10/09 10:17:00+00,508
65,557,45,2020/12/05 05:00:00+00,512,2022/10/09 10:17:00+00,509
0,479,2,2020/12/12 05:00:00+00,477,2022/10/09 10:17:00+00,510
0,401,5,2021/01/02 05:00:00+00,396,2022/10/09 10:17:00+00,511
45,845,8,2021/01/02 05:00:00+00,837,2022/10/09 10:17:00+00,512
45,996,17,2021/01/16 05:00:00+00,979,2022/10/09 10:17:00+00,513
45,908,5,2021/01/23 05:00:00+00,903,2022/10/09 10:17:00+00,514
65,483,66,2021/01/23 05:00:00+00,417,2022/10/09 10:17:00+00,515
0,441,9,2021/01/30 05:00:00+00,432,2022/10/09 10:17:00+00,516
65,456,60,2021/01/30 05:00:00+00,396,2022/10/09 10:17:00+00,517
45,541,6,2021/02/13 05:00:00+00,535,2022/10/09 10:17:00+00,518
65,173,10,2021/02/20 05:00:00+00,163,2022/10/09 10:17:00+00,519
20,486,3,2021/02/27 05:00:00+00,483,2022/10/09 10:17:00+00,520
20,382,0,2021/03/06 05:00:00+00,382,2022/10/09 10:17:00+00,521
20,339,0,2021/03/13 05:00:00+00,339,2022/10/09 10:17:00+00,522
45,237,0,2021/03/13 05:00:00+00,237,2022/10/09 10:17:00+00,523
20,331,0,2021/03/20 04:00:00+00,331,2022/10/09 10:17:00+00,524
45,210,0,2021/03/20 04:00:00+00,210,2022/10/09 10:17:00+00,525
65,103,0,2021/03/20 04:00:00+00,103,2022/10/09 10:17:00+00,526
20,287,0,2021/04/03 04:00:00+00,287,2022/10/09 10:17:00+00,527
45,149,0,2021/04/03 04:00:00+00,149,2022/10/09 10:17:00+00,528
20,266,0,2021/04/10 04:00:00+00,266,2022/10/09 10:17:00+00,529
20,342,0,2021/04/17 04:00:00+00,342,2022/10/09 10:17:00+00,530
0,202,0,2021/05/01 04:00:00+00,202,2022/10/09 10:17:00+00,531
45,189,0,2021/05/01 04:00:00+00,189,2022/10/09 10:17:00+00,532
45,136,0,2021/05/08 04:00:00+00,136,2022/10/09 10:17:00+00,533
45,122,0,2021/05/15 04:00:00+00,122,2022/10/09 10:17:00+00,534
20,239,0,2021/05/22 04:00:00+00,239,2022/10/09 10:17:00+00,535
