OBJECTID,MSAName,GEOIDMSA,Under18_Tot,Under5_Tot,Under5_ER,Under5_Hosp,FivePlus_Tot,FivePlus_ER,Tot_ER_Visits,Tot_Hosp_Visits,AsthmaCt,Diabetes1Ct,Diabetes2Ct,DiabatesOtherCt,PctUndr5ER,PctOvr5ER,PctAsthma,PctDiabetes,Shape__Area,Shape__Length
1,Battle Creek MSA,12980,4962,2365,842,1523,2597,1041,1883,3079,205.0,12.0,,0,0.356025369978858,0.400847131305352,0.0413139862958484,,20025380011.9006,570440.083723278
2,Midland MSA,33220,2069,983,354,629,1086,453,807,1262,41.0,,,0,0.360122075279756,0.417127071823204,0.0198163363943934,,14721619600.1348,495513.005528722
3,South Bend Mishawaka MSA,43780,1868,839,285,554,1029,425,710,1158,32.0,6.0,,0,0.33969010727056,0.413022351797862,0.0171306209850107,,14172499620.5146,477906.502716492
4,Sault Ste Marie Micropolitan Area,42300,955,483,165,318,472,173,338,617,21.0,,,0,0.341614906832298,0.366525423728814,0.0219895287958115,,75491754192.8887,1748640.78670814
5,Coldwater Micropolitan Area,17740,1876,915,351,564,961,426,777,1099,36.0,,,0,0.383606557377049,0.443288241415193,0.0191897654584222,,14489216998.8914,481789.742871195
6,Marquette Micropolitan Area,32100,1710,816,285,531,894,369,654,1056,40.0,7.0,,0,0.349264705882353,0.412751677852349,0.0233918128654971,,95879894725.1582,1441801.65241322
7,Owosso Micropolitan Area,37020,2655,1258,405,853,1397,529,934,1721,43.0,,,0,0.321939586645469,0.378668575518969,0.016195856873823,,15078093079.4536,492754.266553044
8,Holland Micropolitan Area,26090,3489,1642,598,1044,1847,757,1355,2134,85.0,,,0,0.364190012180268,0.409853817000541,0.0243622814560046,,51101130803.231,1065898.0698355
9,Kalamazoo Portage MSA,28020,8947,4282,1521,2761,4665,1926,3447,5500,325.0,42.0,,0,0.355207846800561,0.412861736334405,0.0363250251480943,,46559128352.0049,1216492.91197372
10,Mount Pleasant Micropolitan Area,34380,1880,872,337,535,1008,440,777,1103,70.0,,,0,0.386467889908257,0.436507936507937,0.0372340425531915,,16104720501.9092,508222.332576489
11,Jackson MSA,27100,4987,2436,871,1565,2551,1071,1942,3045,209.0,23.0,,0,0.357553366174056,0.419835358682869,0.0419089633045919,,20168731096.5078,573111.434689146
12,Houghton Micropolitan Area,26340,1205,535,188,347,670,279,467,738,39.0,,,0,0.351401869158879,0.416417910447761,0.0323651452282158,,209589171210.539,2382305.7784346
13,Marinette Micropolitan Area,31940,640,265,93,172,375,141,234,406,,,,0,0.350943396226415,0.376,,,37379520487.1641,1106756.74527055
14,Escanaba Micropolitan Area,21540,1242,570,168,402,672,242,410,832,10.0,7.0,,0,0.294736842105263,0.360119047619048,0.0080515297906602,,55650308640.1016,1060091.33780379
15,Sturgis Micropolitan Area,44780,2633,1196,427,769,1437,598,1025,1608,94.0,7.0,,0,0.357023411371237,0.416144745998608,0.0357007216103304,,14527018260.7573,498278.569413775
16,Adrian Micropolitan Area,10300,3170,1506,548,958,1664,694,1242,1928,106.0,20.0,,0,0.363877822045153,0.417067307692308,0.0334384858044164,,21229318606.4145,589498.255354403
17,Iron Mountain Micropolitan Area,27020,1051,482,143,339,569,204,347,704,6.0,,,0,0.296680497925311,0.358523725834798,0.005708848715509,,21724517379.8223,665016.423656741
18,Alpena Micropolitan Area,10980,1041,472,163,309,569,229,392,649,18.0,,,0,0.345338983050847,0.402460456942004,0.0172910662824208,,47309968086.2627,1010398.06767892
19,Flint MSA,22420,13925,7137,2560,4577,6788,2883,5443,8482,886.0,97.0,8.0,0,0.358694129185932,0.424720094284031,0.0636265709156194,0.00754039497307,18106360188.4829,571503.059489988
20,Monroe MSA,33780,3544,1585,584,1001,1959,838,1422,2122,169.0,14.0,6.0,0,0.368454258675079,0.427769270035733,0.047686230248307,0.0056433408577878,18959797613.8997,572778.994782865
21,Cadillac Micropolitan Area,15620,2016,977,348,629,1039,430,778,1238,44.0,,,0,0.356192425793245,0.41385948026949,0.0218253968253968,,32055309068.5879,761990.47452871
22,Lansing East Lansing MSA,29620,10382,5227,1855,3372,5155,2125,3980,6402,449.0,29.0,9.0,0,0.354888081117276,0.412221144519884,0.0432479291080717,0.003660181082643,47795374450.7952,1003935.68526188
23,Grand Rapids Wyoming MSA,24340,26359,13028,4531,8497,13331,5198,9729,16630,1191.0,69.0,10.0,0,0.347789376727049,0.389918235691246,0.045183808186957,0.0029970787966159,105954501285.646,2094248.87904336
24,Big Rapids Micropolitan Area,13660,1768,822,325,497,946,425,750,1018,53.0,,,0,0.395377128953771,0.449260042283298,0.0299773755656109,,15923868851.835,505161.047626716
25,Bay City MSA,13020,3650,1671,626,1045,1979,872,1498,2152,157.0,9.0,,0,0.374625972471574,0.440626579080344,0.043013698630137,,17583936656.877,602239.819410187
26,Ionia Micropolitan Area,26960,2291,1159,430,729,1132,469,899,1392,48.0,,,0,0.371009490940466,0.414310954063604,0.0209515495416849,,16167844869.6538,508042.179325153
27,Detroit Warren Dearborn MSA,19820,118680,58840,20702,38138,59840,25322,46024,72656,9727.0,462.0,140.0,0,0.351835486063902,0.423161764705882,0.0819598921469498,0.0050724637681159,118063878900.848,1830421.76312169
28,Niles Benton Harbor MSA,35660,5041,2387,853,1534,2654,1112,1965,3076,200.0,23.0,10.0,0,0.357352325094261,0.418990203466466,0.0396746677246578,0.0065463201745685,44091616785.7319,856680.567248575
29,Traverse City Micropolitan Area,45900,3886,1780,551,1229,2106,735,1286,2600,87.0,7.0,,0,0.309550561797753,0.349002849002849,0.0223880597014925,,127376141323.765,1776130.09849819
30,Hillsdale Micropolitan Area,25880,2054,983,383,600,1071,471,854,1200,39.0,,,0,0.389623601220753,0.439775910364146,0.0189873417721519,,16924403694.0713,523755.130404832
31,Muskegon MSA,34740,7705,3742,1333,2409,3963,1616,2949,4756,442.0,23.0,8.0,0,0.356226616782469,0.407771889982337,0.0573653471771577,0.0040233614536015,40697749346.8896,968551.372933742
32,Alma Micropolitan Area,10940,1618,759,297,462,859,372,669,949,47.0,,,0,0.391304347826087,0.433061699650757,0.0290482076637824,,15933524624.7285,507836.233510427
33,Saginaw MSA,40980,7441,3588,1341,2247,3853,1712,3053,4388,394.0,49.0,10.0,0,0.373745819397993,0.444329094212302,0.052949872328988,0.0079290417954576,22745252374.2563,676539.788512654
34,Ludington Micropolitan Area,31220,1277,560,221,339,717,320,541,736,34.0,,,0,0.394642857142857,0.446304044630404,0.0266249021143305,,34644038526.9199,798625.850107897
35,Ann Arbor MSA,11460,4544,2165,685,1480,2379,862,1547,2997,400.0,13.0,,0,0.316397228637413,0.362337116435477,0.0880281690140845,,20138770311.0151,575259.968163202
